5 5 5 5 5 5 5 5 5 5 5 5 5 5 5 5
5 0 0 0 0 0 0 4 0 0 0 0 0 0 0 5
5 0 0 0 0 0 0 1 0 0 0 0 0 0 0 5
5 0 2 1 1 1 1 2 1 1 1 1 2 0 0 5
5 0 1 0 0 0 0 1 0 0 0 0 1 0 0 5
5 0 1 0 0 0 0 1 0 0 0 0 1 0 0 5
5 0 1 0 0 0 0 1 0 0 0 0 1 0 0 5
5 0 1 0 0 0 0 1 0 0 0 0 1 0 0 5
5 0 1 0 0 0 0 1 0 0 0 0 1 0 0 5
5 0 1 0 0 0 0 1 0 0 0 0 1 0 0 5
5 0 2 1 1 1 1 2 1 1 1 1 2 1 3 5
5 5 5 5 5 5 5 5 5 5 5 5 5 5 5 5